" ################### ",
" S                 # ",
" #                 # ",
" #                 # ",
" #                 # ",
" #                 # ",
" #                 # ",
" #                 # ",
" #                 # ",
" #################E# ",
