" ################### ",
" #                 S ",
" # WWWWWWW WWWWWWWW# ",
" #       W         # ",
" #WWWWWW W WWWWWWW # ",
" #         W       # ",
" # WWWWWWW WWWWWWWW# ",
" #       W         # ",
" #WWWWWWWWWWWWWWWW E ",
" ################### ",
