" ################### ",
" S                 # ",
" # WWWWWWWWWWWWWW  # ",
" #                 # ",
" #  WWWWWWWWWWWWWWW# ",
" #                 # ",
" #WWWWWWWWWWWWWWW  # ",
" #                 # ",
" E                 # ",
" ################### ",
