" ################### ",
" S                 # ",
" # WWWWWWWWWWWWWW  # ",
" # W            W W# ",
" # W WWWWWWWW W W W# ",
" #          W W W W# ",
" #  WWWWWWWWW W W W# ",
" #  WWWWWWWWWWW   W# ",
" #                 E ",
" ################### ",
