" ################### ",
" S                 # ",
" #                 # ",
" #  WWWWWWWWWWWWWWW# ",
" #                 # ",
" #                 # ",
" #  WWWWWWWWWWWWW  # ",
" #                 # ",
" #                 # ",
" #################E# ",
