" ################### ",
" S   W           W # ",
" # W W WWWWWWWWW W # ",
" # W W W       W W # ",
" # W W W WWWWW W WW# ",
" # W W W     W W   # ",
" # W W WWWWW WWW W # ",
" # W W       W   W # ",
" # W WWWWWWWWWWE   # ",
" ################### ",
