" ################### ",
" S                 # ",
" # WWWWWWWWWWWWWW W# ",
" # W            W W# ",
" # W WWWWWWWWWW W W# ",
" # W W        W W W# ",
" # W W WWWWWW W W W# ",
" # W W        W W W# ",
" # W WWWWWWWWWW W  # ",
" #################E# ",
