" ##S################ ",
" #    W            # ",
" # WWWW W WWWWWWWWW# ",
" #    W W W        # ",
" #WWW WWW WWWWWWWW # ",
" #    W          W # ",
" # WWWW WWWWWWWW W # ",
" #      W          # ",
" #WWWWWWWWWWWWWWWW # ",
" #################E# ",
