" ################### ",
" S                 # ",
" # WWWWWWWWWWWWWWWW# ",
" #                 # ",
" #WWWWWWWWWWWWWWWW # ",
" #                 # ",
" # WWWWWWWWWWWWWWWW# ",
" #                 # ",
" #WWWWWWWWWWWWWWWW # ",
" #################E# ",
